00000000000000000000
00000000100000100000
00000001000000100000
00000010000000000000
00000111111000044000
00000000001000000000
00000000001000000000
00000000001000000000
00000000001000000000
11111000001111000000
00000300000000030000
00000000056780000000
00060000002000000000
00060000022000001111
11111100022220000000
00000100022220000000
00000100500022011111
00011100006000012222
00000000111007002000
00000000191008002000